{
    "maze": [
        "###############",
        "#C#.#...#.....#",
        "#.#.#.#.#.###.#",
        "#..T.C#...#E.B#",
        "#.#############",
        "#...#.........#",
        "#.###.###.###.#",
        "#.#S..#C#.#...#",
        "#.#####.#####.#",
        "#.#T.C.C#C#C#.#",
        "#.#.#####.#.#.#",
        "#T....#.#.#..T#",
        "###.#.#.#.###.#",
        "#C..#..T.T....#",
        "###############"
    ]
}
