{
  "maze": [
    ["#","#","#","#","#","#","#","#","#","#","#","#","#","#","#"],
    ["#","G","#"," ","#"," "," "," ","#"," "," "," "," "," ","#"],
    ["#"," ","#"," ","#"," ","#"," ","#"," ","#","#","#"," ","#"],
    ["#"," "," ","T"," ","G","#"," "," "," ","#","E"," ","B","#"],
    ["#"," ","#","#","#","#","#","#","#","#","#","#","#","#","#"],
    ["#"," "," "," ","#"," "," "," "," "," "," "," "," "," ","#"],
    ["#"," ","#","#","#"," ","#","#","#"," ","#","#","#"," ","#"],
    ["#"," ","#","S"," "," ","#","G","#"," ","#"," "," "," ","#"],
    ["#"," ","#","#","#","#","#"," ","#","#","#","#","#"," ","#"],
    ["#"," ","#","T"," ","G"," ","G","#","G","#","G","#"," ","#"],
    ["#"," ","#"," ","#","#","#","#","#"," ","#"," ","#"," ","#"],
    ["#","T"," "," "," "," ","#"," ","#"," ","#"," "," ","T","#"],
    ["#","#","#"," ","#"," ","#"," ","#"," ","#","#","#"," ","#"],
    ["#","G"," "," ","#"," "," ","T"," ","T"," "," "," "," ","#"],
    ["#","#","#","#","#","#","#","#","#","#","#","#","#","#","#"]
  ],
  "B":[11,13,9,15],
  "PlayerSkills":[[8,4],[2,0],[4,2],[6,3]],
  "minRouds": 13,
  "CoinConsumption": 219
}
